static const iconMainNagivationAddressBookSvg = 'assets/svgs/main/icon_main_nagivation_address_book.svg';
static const iconMainNagivationAddressBookLightSvg = 'assets/svgs/main/icon_main_nagivation_address_book_light.svg';
static const iconMainNagivationMessageSvg = 'assets/svgs/main/icon_main_nagivation_message.svg';
static const iconMainNagivationMessageLightSvg = 'assets/svgs/main/icon_main_nagivation_message_light.svg';
static const iconMainNagivationOtcSvg = 'assets/svgs/main/icon_main_nagivation_otc.svg';
static const iconMainNagivationOtcLightSvg = 'assets/svgs/main/icon_main_nagivation_otc_light.svg';
static const iconMainNagivationSettingSvg = 'assets/svgs/main/icon_main_nagivation_setting.svg';
static const iconMainNagivationSettingLightSvg = 'assets/svgs/main/icon_main_nagivation_setting_light.svg';
static const iconMainNagivationWalletSvg = 'assets/svgs/main/icon_main_nagivation_wallet.svg';
static const iconMainNagivationWalletLightSvg = 'assets/svgs/main/icon_main_nagivation_wallet_light.svg';
static const iconWalletAcceptEnableSvg = 'assets/svgs/main/icon_wallet_accept_enable.svg';
static const iconWalletAcceptEnableDarkSvg = 'assets/svgs/main/icon_wallet_accept_enable_dark.svg';
static const iconWalletAcceptUnableSvg = 'assets/svgs/main/icon_wallet_accept_unable.svg';
static const iconWalletAcceptUnableDarkSvg = 'assets/svgs/main/icon_wallet_accept_unable_dark.svg';
static const iconWalletErcCoinSvg = 'assets/svgs/main/icon_wallet_erc_coin.svg';
static const iconWalletExchangeEnableSvg = 'assets/svgs/main/icon_wallet_exchange_enable.svg';
static const iconWalletExchangeEnableDarkSvg = 'assets/svgs/main/icon_wallet_exchange_enable_dark.svg';
static const iconWalletNewsTimeSvg = 'assets/svgs/main/icon_wallet_news_time.svg';
static const iconWalletScanEnableSvg = 'assets/svgs/main/icon_wallet_scan_enable.svg';
static const iconWalletScanUnableCopySvg = 'assets/svgs/main/icon_wallet_scan_unable copy.svg';
static const iconWalletScanUnableSvg = 'assets/svgs/main/icon_wallet_scan_unable.svg';
static const iconWalletScanUnableDarkSvg = 'assets/svgs/main/icon_wallet_scan_unable_dark.svg';
static const iconWalletSellEnableSvg = 'assets/svgs/main/icon_wallet_sell_enable.svg';
static const iconWalletSellEnableDarkSvg = 'assets/svgs/main/icon_wallet_sell_enable_dark.svg';
static const iconWalletTransferSvg = 'assets/svgs/main/icon_wallet_transfer.svg';
static const iconWalletTransferDarkSvg = 'assets/svgs/main/icon_wallet_transfer_dark.svg';
static const iconWalletTransferUnableSvg = 'assets/svgs/main/icon_wallet_transfer_unable.svg';
static const iconWalletTransferUnableDarkSvg = 'assets/svgs/main/icon_wallet_transfer_unable_dark.svg';
static const iconWalletTrcCoinSvg = 'assets/svgs/main/icon_wallet_trc_coin.svg';
static const iconWalletUsdtCoinSvg = 'assets/svgs/main/icon_wallet_usdt_coin.svg';
